.....................................................................................................................................................................
.~~~~~~~~~~~~~~~~~~~~~~~~~!!........!~~~!~~~~~~~~~~~~~~~~~~~~~~~~~~~~~~~~~~~~~~~~~~~~~~~~~~.~~~~~~~~~~~~~~~~~~~~~~~~~~~~~~~~~.~~~~~~~~~~~~~~~~~~~~~~~~~~~~~~~~~~~~~~.
.~~~~~~~~~~~~~~~~~~~~~~~~~~~~~~~~~~~~~~~!~~~~~~~~~~~~~~~~~~~~~~~~~~~~~~~~~~~~~~~~~~~~~~~~~~..~~~~~~~~~~~~~~~........~~~~~~~~~.~~~~~~~~~~~~~~~~~~~~~~~~~~~~~~~~~~~~~~.
.~~~~~~~~~~~~!~~~~~~~~~~~~~~~~~~~~~~~~~~!~~~~~~~~~~~~~~!~~~~~~~~~~~~~~~~~~~~~~~~~~~~~~~~~~~!~~~~~~~~~~~~~~~.~~~~~~~.~~~~~~~~~.~~~~~~~~~~~~~~~~~~~~~~~~~~~~~~~~~~~~~~.
.~~~~~~~~~..!~!~~~~~~~~~~~~~~~~~~~~~~~~~!~~~~~~~~~~~~~~!.~~~~~~~~~~~~~~~~~~~~~~~~~~!~~~~~~~!~~~~~~~!!!....!~~~~~~~~.~~~~^~~~~.~~~~~~~~~~~~~~~~~~~~~~~~~~~~~~~~~~~~~~.
.....~~~~~~~.!~~~....~~~~~~~~~~~~~~~~~~...~~~~~~~~~~~~~!~~!~~~.~~~~.~~~~~....~~~~~.!~~~~~~~!~~~~~~~!~~~~~~~~~~~~~~~...........~~~~~~~~~~~~~~~~~~~~~~~~~~~~~~~~~~~~~~.
.~~~~~~~~~~~.!~~~~~~~~~~~~~.~~..~~~~~~~~~~~~~~~~~~~~~~~!!!!!!!!!!!!!!!!!!!!!!!!!!!!!!!!~~~~~~~~~~~~!~~~~~~~~~~~~~~~~~~~~~~~~~~~~~~~~~~~~~~~~~~~~~~~~~~~~~~~~~~~~~~~~.
.~~~~~~~~~~~.!!!!!!!!!!!!!!!!!!!!!!!~~~~~~~~~~~~~~~~~~.~~!.............................!~~~~~~~~~~...~~~~~~~~~~~~~~~~~~~~~~~~~~~~~~~~~~~~~~~~~~~~~~~~~~~~~~~~~~~~~~~.
.~~~~~~............................!~~~~~~~~~~~~~~~~~~~~~!.~~~~~~~~~~~~~~~.!!!~~~~~~~~..!............~~~~~~~~~~~~~~~~~~~~~~~~~~~~~~~~~~~~~~~~~~~~~~~~~~~~~~~~~~~~~~~.
.~~~~~~~~~~~~~~~~~~~~~~~~~~~~~~~~~.!~~~~~~~~~~~~.~~~~!!!!!.~~~~~~~~~~~~~~~.~~~~~~~~~~~~..~~~~~~~~~~~~~~~~~~~~~~~~~~~~~~~~~~~~~~~~~~~~~~~~~~~~~~~~~~~~~~~~~~~~~~~~~~~.
.~~~~~~~~~~~~~~~~~~~~~~~~~~~~~~~~~.!.~~~~~..~~~~~~~~~!.........~~~~~~~~~~~.~~~~~~~~~~~~~~~~~~~~~~~~~~~~~~~~~~~~~~~~~~~~~~~~~~~~~~~~~~~~~~~~~~~~~~~~~~~~~~~~~~~~~~~~~.
.~~~~~~~~~~~~~~~~~~~~~~~~~~~~~~~~~.!!!!!!!!!!!!!!!!!!!.~~~~~~~~~~~~~~~~~~~.~~~~~~~~~~~~~~~~~~~~~~~~~~~~~~~~~~~~~~~~~~~~~~~~~~~~~~~~~~~~~~~~~~~~~~~~~~~~~~~~~~~~~~~~~.
.~~~~~~~~~~~~~~~~~~~~~~~~~~~~~~~~~.....................~~~~~~~~~~~~~~~~~~~.~~~~~~~~~.......~~~~~~~~~~~~~~~~~~~~~~~~~~~~~~~~~~~~~~~~~~~~~~~~~~~~~~~~~~~~~~~~~~~~~~~~~.
.......~~~~~~~~~~~~~~~~~~~~~~~~~~~~~~~~~~~~~~~~~~..~~~~~~~~~~~~~~~~~~~~~~~.~~~~~~~~~~~~.~~~~~~~~~~~~~~~~~~~~~~~~~~~~~~~~~~~~~~~~~~~~~~~~~~~~~~~~~~~~~~~~~~~~~~~~~~~~.
.~~~~~~~~~~~~~~~~~~~~~~~~~~~~~~~~~~~~~~~~~~~~~~~~~.~~~~~~~~.......~~~~~~~~.~~~~~~~~~~~~.~~~~~~~~~~~.~~~~.~~~~......~~~~.~~~~.~~~~~~~~~~~~~~~~~~~~~~~~~~~~~~~~~~~~~~~.
.~~~~~~~~~~~.~~~~~~~~~~~~~~~~~~~~~~~~~~~~~~~~~~~~~.~~~~~~~~~~~.~~~~~~~~~~~.....~~~~~~~~.~~~~~~~~~~~.~~~~.~~~~.~~~~.~~~~.~~~~.~~~~~~~~~~~~~~~~~~~~~~~~~~~~~~~~~~~~~~~.
.~~~~~~~~~~~......~~~~~~~~~~~~~~~~~~~~~~~~~~~~~~~~.~~~~~~~~~~~.~~~~~~~~~~~.~~~~~~~~~~~~.~~~~~~~~~~~.~~~~.~~~~.~~~~.~~~~.~~~~.~~~~~~~~~~~~~~~~~~~~~~~~~~~~~~~~~~~~~~~.
.~~~~~~~~~~~~~~~~~~~~~~~~~~~~~~~~~~~~~~~~~~~~~~~~~.~~~~~~~~~~~.~~~~~~~~~~~.~~~~~~~~~~~~.~~~~~~~~~~~~.~~.~~~~~.~~~~.~~~~.~~~~.~~~~~~~~~~~~~~~~~~~~~~~~~~~~~~~~~~~~~~~.
.~~~~~~~~~~~~~~~~~~~~~~~~~~~~~~~~~~~~~~~~~~~~~~~~~.~~~~~~~~~~~.~~~~~~~~~~~.~~~~~~~~~~~~.~~~~~~~~~~~~~..~~~~~~.~~~~.~~~~.~~~~.~~~~~~~~~~~~~~~~~~~~~~~~~~~~~~~~~~~~~~~.
.~~~~~~~~~~~~~~~~~~~~~~~~~~~~~~~~~~~~~~~~~~~~~~~~~.~~~~~~~~~~~.~~~~~~~!!!!.~~~~~~~~~~~~.~~~~~~~~~~~~~.~~~~~~~.~~~~.~~~~.~~~~.~~~~~~~~~~~~~~~~~~~~~~~~~~~~~~~~~~~~~~~.
.~~~~~~~~~~~~~~~~~~~~~~~~~~~~~~~~~~~~~~~~~~~~~~~~~.~~~~~~~~~~~.~~~~!!!~~~~.~~~......~~~.~~~~~~~~~~~~.~~~~~~~~......~~~~......~~~~~~~~~~~~~~~~~~~~~~~~~~~~~~~~~~~~~~~.
..~~~~!!!!..~~~~~~~~~~~~~~~.....!!!!......~~~~~~~~.~~~~~~~~~~~.~~~~~~~~~~~.~~~~~~~~~~~~.~~~~~~~~~~~.~~~~~~~~~~~~~~~~~~~~~~~~~~~~~~~~~~~~~~~~~~~~~~~~~~~~~~~~~~~~~~~~.
.~~~~~~~~~~~~~~~~~~~~~~~~~~~~~~~~~~~~~~~~~~~~~~~~~....~~~~~~~~.~~~~~~~~~~~.~~~~~~~~~~~~.~~~~~~~~~~~~~~~~~~~~~~~~~~~~~~~~~~~~~~~~~~~~~~~~~~~~~~~~~~~~~~~~~~~~~~~~~~~~.
.~~~~~~~~!~~~~~~~~~~~~~~~~~~~~~~~~~~~~~~~~~~~~~~~~.~~~~~~~~~~~.~~~~~~~~~~~.~.~~~~~~~~.~.~~~~~~~~~~~~~~~~~~~~~~~~~~~~~~~~~~~~~~~~~~~~~~~~~~~~~~~~~~~~~~~~~~~~~~~~~~~~.
.........!!!~~~~~~~~~~~~~~~!!!~~~~~~~~~~~~~~~~~~~~.~~~~~~~~~~~....~~~~~~~~.!!!~~~~~~!!!.~~~~~~~~~~~~~~~~~~~~~~~~~~~~~~~~~~~~~~~~~~~~~~~~~~~~~~~~~~~~~~~~~~~~~~~~~~~~.
.~~~~~~~~~~!~~~~~~~~~~~~~!!!!!!!~~~~~~~~~~~~~~~~~~.~~~~~~~~~~~.~~~~~~~~~~~.~~~~~..~~~~~.~~~~~~~~~~~~~~~~~~~~~~~~~~~~~.~~~~~~~~~~~~~~~~~.~~~.......~~~~~.~~~~~.~~~~~~.
.~~~~~~~~~~~~~~~~~~~~~~~~..!!!~~~~~~~~~~~~~~~~~~~~.~~~~~~~~~~~.~~~~~~~~~~~.~~~~~~~~~~~~.~~~~~~~~~~~~~~~~~~~~~~~~~~~~~~.~~~~~~~~~~~~~~~.~~~~~~~.~~~~~~~~..~~~~.~~~~~~.
....~~~~~~~......~~~~~~~~~~~~~~~~~~~~~~~~~~~~~~~~~.~~~~~~~~~~~.~~~~~~~~~~~.~~~~~~~~~~~~.~~~~~~~~~~~~~~~~~~~~~~~~~~~~~~~.~~~~~~~~~~~~~.~~~~~~~~.~~~~~~~~.~.~~~.~~~~~~.
.~!!~~~~~~~~~~~~~~~~~~~~~~~~~~~~~~~~~~~~~~~~~~~~~~.~~~~~~~~....~~~~~~!!!!!.~~~~~~~~~~~~.~~~~~~~~~~~~~~~~~~~~~~~~~~~~~~~~.~~~~~.~~~~~.~~~~~~~~~.~~~~~~~~.~~.~~.~~~~~~.
.~!!~~~~~~~~~~~~~~~~~~~~~~~~~~~~~~~~~~~~~~~~~~~~~~.~~~~~~~~~~~.~~~~~~~~~~~.~~~~~..~~~~~.~~~~~~~~~~~~~~~~~~~~~~~~~~~~~~~~~.~~~.~.~~~.~~~~~~~~~~.~~~~~~~~.~~~.~.~~~~~~.
.~!!~~~~~~~.........~~~~~~~........................~~~~~~~~~~~.~~~~~~~~~~~.~~~~~!!!!!!!.~~~~~~~~~~~~~~~~~~~~~~~~~~~~~~~~~~.~.~~~.~.~~~~~~~~~~~.~~~~~~~~.~~~~..~~~~~~.
.!!!~~~~~~!~~~~~~~~~!!!!!!!~~~~~~~~~~~~~~~~~~~~~~~.~~~~~~~~~~~.~~~~~~~~~~~.~~~~~~~~~~~~.~~~~~~~~~~~~~~~~~~~~~~~~~~~~~~~~~~~.~~~~~.~~~~~~~~~.......~~~~~.~~~~~.~~~~~~.
.~~~~~~~!!~~~~~~~~~~~~~~~~~~~~~~~~~~~~~~~~~~~~~~~~.~~~~~~~~~~~.~~~~~~~~~~~.~~~~~~~~~~~~.~~~~~~~~~~~~~~~~~~~~~~~~~~~~~~~~~~~~~~~~~~~~~~~~~~~~~~~~~~~~~~~~~~~~~~~~~~~~.
.~~~~...~~~~~~~~~~~~~~~~~~~~~~~~~~~~~~~~~~~~~~~~~~.~~~~~~~~~~~.!!!~~~~~~~~.~~~~~~~~~~~~.~~~~~~~~~~~~~~~~~~~~~~~~~~~~~~~~~~~~~~~~~~~~~~~~~~~~~~~~~~~~~~~~~~~~~~~~~~~~.
.~~~~~~~~~~~~~~~~~~~~~~~~~~~~~~~~~~~~~~~~~~~~~~~~~....~~~~~~~~.~~~~~~~~~~~.~~~~~~~~~~~~.~~~~~~~~~~~~~~~~~~~~~~~~~~~~~~~~~~~~~~~~~~~~~~~~~~~~~~~~~~~~~~~~~~~~~~~~~~~~.
.~~~~~~~~~~~~~~~~~~~~~~~~~~~~~~~~~~~~~~~~~~~..~~~~.~~~~~~~~~~~.~~~~~~~~~~~.~~..~~~~~~~~.~~~~~~~~~~~~~~~~~~~~~~~~~~~~~~~~~~~~~~~~~~~~~~~~~~~~~~~~~~~~~~~~~~~~~~~~~~~~.
.......~~~~~~~~~~~~~~~~~~~~~~~~~~~~~~~~~~~~~~~~~~~.~~~~~~~~~~~.~~~~~~~~~~~.!!!!!!!!~~~~.~~~~~~~~~~~~~~~~~~~~~~~~~~~~~~~~~~~~~~~~~~~~~~~~~~~~~~~~~~~~~~~~~~~~~~~~~~~~.
.!~~~~~~~~~~~~~~~~~~~~.....~~~~~~~~~~~~~~~~!!!!~~~.~~~~~~~~~~~.~~~~~~!!!~~.....~~~~~~~~.~~~~~~~~~~~~~~~~~~~~~~~~~~~~~~~~~~~~~~~~~~~~~~~~~~~~~~~~~~~~~~~~~~~~~~~~~~~~.
.!~~~~~~~~~~~~~~~~~~~~~~~~~~~~~~~~~~~~~~...........~~~~~~~~....~~~~~~~~~~~.~~~~~~~~~~~~.~~~~~~~~~~~~~~~~~~~~~~~~~~~~~~~~~~~~~~~~~~~~~~~~~~~~~~~~~~~~~~~~~~~~~~~~~~~~.
.!!!!~~~~~~~~~~~~~~~~~~~~~~~~~~~~~~~~~~~.~~~~~~~~~~~~~~~~~~~~~.~~~~~~~~~~~.~~~~~~~~~~~~.~~~~~~~~~~~~~~~~~~~~~~~~~~~~~~~~~~~~~~~~~~~~~~~~~~~~~~~~~~~~~~~~~~~~~~~~~~~~.
.!~~~~~~~~~~~~~~~~~~~~~~~~~~~~~~~~~~~~~~.~~~~~~~~~~~~~~~~~~~~~.~~~~~~~~~~~.~~~~~~~~~~~~.~~~~~~~~~~~~~~~~~~~~~~~~~~~~~~~~~~~~~~~~~~~~~~~~~~~~~~~~~~~~~~~~~~~~~~~~~^~~.
.!~~~~~~~~~~~....~~~~~~~~~~~~~~....~~~~~.~~~~~~~~~.~~~~~~~~~~~.~!!!~~~~~~~.~~~~~~.......~~~~~~~~~~~~~~~~~~~~~~~~~~~~~~~~~~~~~~~~~~~~~~~~~~~~~~~~~~~~~~~~~~~~~........
.!~~~~~~~~~~~~~~~~~~~~~~~~~~~~~~~~~~~~~~~~~~~~~~~~....~~~~~~~~.~~~~~~~~~~~.~~~~~~~~~~~~.~~~~~~~~~~~~~~~~~~~~~~~~~~~~~~~~~~~~~~~~~~~~~~~~~~~~~~~~~~~~~~~~~~~~.~~~~~~~.
.!!!!~~~~~~~~~~~~~~~~~~~~~~~~~~~~~~~~~~~~~~~~......~~~~~~~~~~~.~~~~~~~~~~!.~~~~~~~~~~~~.~~~~~~~~~~~~~~~~~~~~~~~~~~~~~~~~~~~~~~~~~~~~~~~~~~~~~~~~~~~~~~~~~~~.~~~~~~~~.
.!~~~~~~~~~~~~~~~~~~~~~~~~~~~~~~~~~~~~~~~~~~~!!~~~.~~~~~~~~~~~.~~~~~~~~~~~~~~~~~~~~~~~~.~~~~~~~~~~~~~~~~~~~~~~~~~~~~~~~~~~~~~~~~~~~~~~~~~~~~~~~~~~~~~~~~~~.~~~~~~~~~.
.!~~~~~~~~~~~~~~~~~~~~~~~~~~~~~~~~~~~~~~~~~~~!!~~~.~~~~~~~~~~~.~~~~~~~~~~~~~~~~~~~~~~~~.~~~~~~~~~~~~~~~~~~~~~~~~~~~~~~~~~~~~~~~~~~~~~~~~~~~~~~~~~~~~~~~~~.~~~~~~~~~~.
.....................................................................................................................................................................